NO ./include/textures/dungeonTexture.png
SO ./include/textures/dungeonTexture.png
WE ./include/textures/dungeonTexture.png
EA ./include/textures/dungeonTexture.png

C 93,142,193
F 231,230,230



111111
100101
101001
1000N1
111111

