NO ./cub_include/textures/brown_weevil.png
SO ./cub_include/textures/happy_weevil.png
WE ./cub_include/textures/glitter_weevil.png
EA ./cub_include/textures/smol_weevil.png

C 93,142 ,     103
F 231,230,230

111111
100101
101E01
100001
111111
