NO ./include/textures/dungeonTexture.png
SO ./include/textures/dungeonTexture.png
WE ./include/textures/dungeonTexture.png
EA ./include/textures/dungeonTexture.png

C 93,142,193
F 231,230,230

11111
10001
10N01
10001
11111
