NO ./include/textures/dungeonTexture.png
SO ./include/textures/dungeonTexture.png
WE ./include/textures/dungeonTexture.png
EA ./include/textures/dungeonTexture.png

C 203,225,20
F 255,9,0

11111111
10100001
10100001
10100001
10000001
10100101
1000N001
11111111
