NO ./include/textures/dungeonTexture.png
SO ./include/textures/dungeonTexture.png
WE ./include/textures/dungeonTexture.png
EA ./include/textures/dungeonTexture.png

C 93,142,193
F 231,230,230

111101111111
111101111111
110000001101
100000000000
100000000000