NO ./include/textures/dungeonTexture.png
SO ./include/textures/dungeonTexture.png
WE ./include/textures/dungeonTexture.png
EA ./include/textures/dungeonTexture.png

C 220,30,0
F 120,220,0

111111
100101
101001
1100N1
111111
