1111111111111
1000001100001
1011011100001
100100000E001
1111111111111
